      ####
    ###  ####
  ### $ $   #
  #   #..#$ #
  # $$#*.#  #
  #   ....$ #
 ## # .#.#  #
 # $##$#.#$ #
 # @$    .$ #
 ##  #  ##  #
  ###########